111111111111111111111111111111111111111111
100000000000000000000000100000000000000001
100000000000000000000000100000000000000401
100000000000000000000000100000000000011111
100000000000000000000000100000000000000001
100000000000000000000000100001111000000001
100000000000000000000000100000000000400001
100000000000000000000000100000000011110001
100000000000000000000000100000004000000001
100000000000000000000000100000011100000001
100000000000000000000000104000000000000001
100000000000000000000000111111000000000001
100000000000000000000000100000000040000001
100000000000000000000000100000000111000001
100000000000000000000000100000000000000001
100000000000003000000000100000000000001111
100000000000000000000000000000000000000001
100000000000400000000000000000000000004001
100000001111111110000000000000000000000001
100000000000000000000000000000000000000001
100111000000000000011100111111111111111111
1000000000000000000000001
1000000000000000000000001
1000400000020000000400001
1111111111111111111111111